13 8 5 20 20
1111111111111
1...........1
12.22222.221
1.2.XXX.2.1
12.22222.221
1...........1
1111111111111
.............