8 8 3 25 25
12121212
21212121
........
XXXXXXXX
1.....1.
.2...2..
..1.1...
...X.... 