13 8 5 20 20
..111...111..
..1.1...1.1..
..2.2...2.2..
..111111111..
.............
.222.....222.
1...22222...1
111.......111