13 8 5 20 20
1111111111111
1.2...X...2.1
1.2.22222.2.1
1.2.2...2.2.1
1.2.22222.2.1
1.2...X...2.1
1111111111111
.............